1111111111111111111111111111111111111111111111111111111111
10C0000000000000000000000000000000000000000000000000100001
101000010000010000010C000001000000000000100000000000000001
100100010C0000C0000000000100000C01000000C00010000100000001
1000000000000100100000000000000000000000000010C00001000001
100000C000000000000000C00000100000000001000000000000000001
10000100C01000C0000001000000000000C0000C0000000000C0100001
1000000000000000000000000000000000000000010000010000000001
100000100000000000000C0000000C00001001000000C0000000000001
1000000C000000000C0000000000010000000C00000000000000000001
100000000000001000000000000000000000000000000001C000000001
100001000000000000000C000000C000P0000000100000000000010001
10000000000C0000000000000010000000000000000000000000000001
100000000000000000000000000000000000000C000000000100000001
1000000001000000C000000001C0000C00000000000100000000000001
10010C00000000001000000000000E0000010000000000000000000001
100000010000000000C000000000000000010000000010000010000001
1000000000000010000000000010000000000000C000000000C0000001
100100C0000C000000000000C000C00000000000000000010010000001
1000000000000000000001000000000010C00010000010000000000001
1000100000100000000000000000000000000000000000000000000001
10000000000000000000000100000000000000100001000C0010000001
1000000C00010001C0000000000C010000000000000000000000000001
100010000000000000000000000000000C100000000000010000000001
1000000000100000000000000100000000000000001000000100000001
1111111111111111111111111111111111111111111111111111111111
