1111111111111111111111111
1000010000000000000100001
10CC01100C000000C00100E01
10CC011100010011000100001
1000001110011C11000000001
1111100110011111000111001
1111100P10001100C00111C01
1111100000000100000111001
1111111111111111111111111