111111111
1001P0001
10C000C01
1000E0001
111111111